{
	"openings":[],

	"npcs":[{
		"id": "vanya",
		"questGiverId": "vanya",
		"type": "naked-guy",
		"x": 21,
		"y": 3,
		"script": {
		}
	}],
	"items":[],
	"scripts": {},
	"name": "bookshop",
	"tileset":"til-tavern",
	"overlayTileset":"til-tavern-decoration",
	"decorationTileset":"til-bookshop-decoration",
	"connections": [{
		"y": 2,
		"x": 14,
		"targetMap": "town_new",
		"targetRoom": "town_new",
		"targetX": 64,
		"targetY": 72
	}],
	"layout":[
		[3,5,11,12,5,5,5,11,12,5,5,5,9,10,5,5,5,11,12,5,5,5,19,8],
		[43,45,51,52,45,45,45,51,53,45,45,45,49,50,45,45,45,51,53,45,13,45,59,48],
		[83,85,91,92,85,85,85,91,93,85,85,85,89,90,85,85,85,91,93,85,85,85,85,88],
		[32,34,72,73,34,34,34,72,73,34,34,34,34,34,34,34,34,72,73,34,34,34,34,37],
		[34,34,34,34,34,34,34,34,34,34,34,34,34,34,34,34,34,34,34,34,34,34,34,34],
		[34,34,34,34,34,34,34,34,34,34,34,34,34,34,34,34,34,34,34,34,34,34,34,34],
		[34,34,34,34,34,34,34,34,34,34,34,34,34,34,34,34,34,34,34,34,34,34,34,34],
		[34,34,34,34,34,34,34,34,34,34,34,34,34,34,34,34,34,34,34,34,34,34,34,34],
		[34,34,34,34,34,34,34,34,34,34,34,34,34,34,34,34,34,34,34,34,34,34,34,34],
		[34,34,34,34,34,34,34,34,34,34,34,34,34,34,34,34,34,34,34,34,34,34,34,34],
		[34,34,34,34,34,34,34,34,34,34,34,34,34,34,45,45,45,34,34,34,34,34,34,34],
		[34,34,34,34,34,34,34,34,34,34,34,34,34,34,85,85,85,34,34,34,34,34,34,34],
		[34,34,34,34,34,34,34,34,34,34,34,34,34,34,34,34,34,34,34,34,34,34,34,34],
		[34,34,34,34,34,34,34,34,34,34,34,34,34,34,34,34,34,34,34,34,34,34,34,34],
		[26,34,34,34,34,34,34,34,34,34,34,34,34,34,34,34,34,34,34,34,34,34,34,34],
		[34,34,34,34,34,34,34,34,34,34,34,34,34,34,34,34,34,34,34,34,34,34,34,34],
		[34,34,34,34,34,34,34,34,34,34,34,34,34,34,34,34,34,34,34,34,34,34,34,34],
		[34,34,34,34,34,34,34,34,34,34,34,34,34,34,34,34,34,34,34,34,34,34,34,34]
	],
	"decorations":[
    [11,12,0,0,0,0,0,0,0,0,0,0,0,0,0,0,0,0,0,0,0,0,0,0],
    [51,52,0,0,0,7,8,0,0,13,14,28,0,0,6,7,8,0,0,0,0,0,0,0],
    [91,92,0,148,0,47,48,0,0,53,54,68,0,0,46,47,48,0,0,0,0,0,0,26],
    [131,132,0,188,226,87,88,0,172,93,94,108,0,0,86,87,88,0,0,0,0,0,0,66],
    [0,0,0,0,0,134,0,0,0,0,0,0,0,0,0,0,0,0,0,137,138,137,138,145],
    [107,0,0,0,0,0,0,0,0,0,0,0,0,0,0,0,0,0,0,177,178,177,178,185],
    [134,22,23,24,0,0,0,0,21,22,23,24,29,17,18,17,18,0,0,0,0,0,0,175],
    [61,62,63,64,0,0,0,0,61,62,63,64,69,57,58,57,58,0,0,0,0,0,148,29],
    [101,102,103,104,0,0,0,0,101,102,103,104,109,97,98,97,98,0,0,0,0,0,188,69],
    [141,142,143,144,27,0,0,0,141,142,143,144,172,0,0,0,0,0,0,0,0,0,0,109],
    [181,135,0,184,67,0,0,0,181,0,0,184,0,6,7,7,8,107,0,0,21,22,23,24],
    [221,0,172,224,0,0,0,0,221,0,172,224,25,46,47,47,48,25,0,0,61,62,63,64],
    [0,0,0,0,0,0,0,0,0,0,0,226,65,86,87,87,88,65,0,0,101,102,103,104],
    [25,0,0,0,0,27,148,25,0,0,0,0,105,148,0,148,0,65,0,0,141,142,143,144],
    [65,0,0,0,0,67,188,65,0,0,0,0,145,188,107,188,0,105,0,0,181,172,0,184],
    [105,0,0,0,0,0,0,105,28,0,0,0,185,0,0,0,0,145,0,0,221,0,0,224],
    [145,0,0,137,138,137,138,145,68,0,0,0,0,0,0,0,0,185,0,0,0,0,0,27],
    [185,0,134,177,178,177,178,185,108,0,0,0,0,0,212,213,214,147,0,0,0,0,0,67]
	],
	"overlays":[
    [0,0,0,0,0,0,0,0,0,0,0,0,0,0,0,0,0,0,0,0,0,0,0,0],
    [0,0,0,0,0,0,0,0,0,0,0,0,0,0,0,0,0,0,0,0,0,0,0,0],
    [0,0,0,0,0,0,0,0,0,0,0,0,0,0,0,0,0,0,0,0,0,0,0,0],
    [0,0,0,0,0,0,0,0,0,0,0,0,0,0,0,0,0,0,0,0,0,0,0,0],
    [0,0,0,0,0,0,0,0,0,0,0,0,0,0,0,0,0,0,0,0,0,0,209,0],
    [0,0,0,0,0,0,0,0,0,0,0,0,0,0,0,0,0,0,0,0,0,0,0,0],
    [0,0,0,0,0,0,0,0,0,0,0,0,0,0,0,0,0,0,0,0,0,0,0,0],
    [0,0,0,0,0,0,0,0,0,0,0,0,0,0,0,0,0,0,0,0,0,0,0,0],
    [0,0,0,0,0,0,0,0,0,0,0,0,0,0,0,0,0,0,0,0,0,0,0,0],
    [0,0,0,0,0,0,0,0,0,0,0,0,0,0,0,0,0,0,0,0,0,0,0,0],
    [0,0,0,0,0,0,0,0,0,0,0,0,0,0,0,0,0,0,0,0,0,0,0,0],
    [0,0,0,0,0,0,0,0,0,0,0,0,0,0,0,0,0,0,0,0,0,0,0,0],
    [0,0,0,0,0,0,0,0,0,0,0,0,0,0,0,0,0,0,0,0,0,0,0,0],
    [0,0,0,0,0,0,0,0,0,0,0,0,0,0,0,0,0,0,0,0,0,0,0,0],
    [0,0,0,0,0,0,0,0,0,0,0,0,0,0,0,0,0,0,0,0,0,0,0,0],
    [0,0,0,0,0,0,0,0,0,0,0,0,0,0,0,0,0,0,0,0,0,0,0,0],
    [0,0,0,0,0,0,0,0,0,0,0,0,0,0,0,0,0,0,0,0,0,0,0,0],
    [0,0,0,0,0,0,0,0,0,0,0,0,0,0,0,0,0,0,0,0,0,0,0,0]
	]
}