{
  "openings": [
    [-1,1, "bottom"]
  ],
  "npcs": [{
    "id": "boss",
    "type": "enemy-zombie",
    "x": 11,
    "y": 6
  }],
  "items": [
    {
      "id": "books",
      "x": 14,
      "y": 14
    }
  ],
  "scripts": {
		"onEntry": []
  },
  "name": "boss-room",
  "tileset": "dungeon",
  "decorationTileset": "town-decoration",
  "overlayTileset": "town-overlay",
  "layout": [
    [13,8,8,8,8,8,8,8,8,8,8,8,8,8,8,8,8,8,8,8,8,8,8,12],
    [6,20,15,15,15,21,15,15,15,21,15,15,15,21,15,15,15,15,21,15,15,15,22,4],
    [6,23,18,18,18,24,18,18,18,24,18,18,18,24,18,18,18,18,24,18,18,18,25,4],
    [6,37,32,32,32,38,32,32,32,38,32,32,32,38,32,32,32,32,38,32,32,32,39,4],
    [6,32,32,33,32,32,32,32,33,32,32,32,32,32,34,32,36,32,32,32,33,32,32,4],
    [6,32,32,32,32,34,32,32,32,32,32,33,32,32,32,32,32,32,32,32,32,34,32,4],
    [6,32,32,32,1,2,3,32,32,34,32,32,36,32,32,32,1,2,3,32,32,32,32,4],
    [6,32,36,32,4,5,6,32,32,32,32,32,32,32,32,32,4,5,6,32,36,32,32,4],
    [6,32,32,32,7,8,9,32,32,36,32,32,34,32,32,32,7,8,9,32,32,32,33,4],
    [6,33,32,32,32,32,32,32,32,32,32,32,32,32,32,32,32,32,32,32,32,32,32,4],
    [6,32,32,32,32,32,32,32,32,32,32,32,32,33,32,32,32,32,33,32,32,32,32,4],
    [6,32,32,34,32,32,32,34,32,32,32,34,32,32,32,32,32,32,32,32,34,32,32,4],
    [6,32,32,32,32,32,32,32,32,32,32,32,32,32,32,32,34,32,32,32,32,32,32,4],
    [6,32,32,32,36,32,32,32,33,32,32,32,32,32,32,32,32,32,32,32,36,32,32,4],
    [6,32,34,32,32,32,32,32,32,32,32,32,32,32,32,32,32,32,32,32,32,32,32,4],
    [6,32,32,32,1,2,3,32,32,32,32,33,32,32,32,32,1,2,3,32,32,33,32,4],
    [6,32,32,32,4,5,6,32,32,32,32,32,32,34,32,32,4,5,6,32,32,32,32,4],
    [6,32,36,32,7,8,9,32,32,36,32,32,32,32,32,32,7,8,9,32,36,32,32,4],
    [6,32,32,32,32,32,32,32,32,32,32,32,32,32,32,32,32,32,32,32,32,32,32,4],
    [6,32,32,32,34,32,33,32,32,32,32,32,32,32,32,32,32,33,32,32,32,32,32,4],
    [6,32,32,32,32,32,32,32,32,32,32,34,32,32,36,32,32,32,32,32,34,32,36,4],
    [6,32,32,32,32,32,32,32,32,32,32,32,32,32,32,32,32,32,32,32,32,32,32,4],
    [6,20,15,15,21,15,15,21,15,15,22,26,27,28,20,15,15,15,21,15,15,15,22,4],
    [6,23,18,18,24,18,18,24,18,18,25,29,30,31,23,18,18,18,24,18,18,18,25,4]
  ],
  "decorations": [
    [0,0,0,0,0,0,0,0,0,0,0,0,0,0,0,0,0,0,0,0,0,0,0,0],
    [0,0,0,0,0,0,0,0,0,0,0,0,0,0,0,0,0,0,0,0,0,0,0,0],
    [0,0,0,0,0,0,0,0,0,0,0,0,0,0,0,0,0,0,0,0,0,0,0,0],
    [0,0,0,0,0,0,0,0,0,0,0,0,0,0,0,0,0,0,0,0,0,0,0,0],
    [0,0,0,0,0,0,0,0,0,0,0,0,0,0,0,0,0,0,0,0,0,0,0,0],
    [0,0,0,0,0,0,0,0,0,0,0,0,0,0,0,0,0,0,0,0,0,0,0,0],
    [0,0,0,0,0,0,0,0,0,0,0,0,0,0,0,0,0,0,0,0,0,0,0,0],
    [0,0,0,0,0,0,0,0,0,0,0,0,0,0,0,0,0,0,0,0,0,0,0,0],
    [0,0,0,0,0,0,0,0,0,0,0,0,0,0,0,0,0,0,0,0,0,0,0,0],
    [0,0,0,0,0,0,0,0,0,0,0,0,0,0,0,0,0,0,0,0,0,0,0,0],
    [0,0,0,0,0,0,0,0,0,0,0,0,0,0,0,0,0,0,0,0,0,0,0,0],
    [0,0,0,0,0,0,0,0,0,0,0,0,0,0,0,0,0,0,0,0,0,0,0,0],
    [0,0,0,0,0,0,0,0,0,0,0,0,0,0,0,0,0,0,0,0,0,0,0,0],
    [0,0,0,0,0,0,0,0,0,0,0,0,0,0,0,0,0,0,0,0,0,0,0,0],
    [0,0,0,0,0,0,0,0,0,0,0,0,0,0,0,0,0,0,0,0,0,0,0,0],
    [0,0,0,0,0,0,0,0,0,0,0,0,0,0,0,0,0,0,0,0,0,0,0,0],
    [0,0,0,0,0,0,0,0,0,0,0,0,0,0,0,0,0,0,0,0,0,0,0,0],
    [0,0,0,0,0,0,0,0,0,0,0,0,0,0,0,0,0,0,0,0,0,0,0,0],
    [0,0,0,0,0,0,0,0,0,0,0,0,0,0,0,0,0,0,0,0,0,0,0,0],
    [0,0,0,0,0,0,0,0,0,0,0,0,0,0,0,0,0,0,0,0,0,0,0,0],
    [0,0,0,0,0,0,0,0,0,0,0,0,0,0,0,0,0,0,0,0,0,0,0,0],
    [0,0,0,0,0,0,0,0,0,0,0,0,0,0,0,0,0,0,0,0,0,0,0,0],
    [0,0,0,0,0,0,0,0,0,0,0,0,0,0,0,0,0,0,0,0,0,0,0,0],
    [0,0,0,0,0,0,0,0,0,0,0,0,0,0,0,0,0,0,0,0,0,0,0,0]
  ],
  "overlays": [
    [0,0,0,0,0,0,0,0,0,0,0,0,0,0,0,0,0,0,0,0,0,0,0,0],
    [0,0,0,0,0,0,0,0,0,0,0,0,0,0,0,0,0,0,0,0,0,0,0,0],
    [0,0,0,0,0,0,0,0,0,0,0,0,0,0,0,0,0,0,0,0,0,0,0,0],
    [0,0,0,0,0,0,0,0,0,0,0,0,0,0,0,0,0,0,0,0,0,0,0,0],
    [0,0,0,0,0,0,0,0,0,0,0,0,0,0,0,0,0,0,0,0,0,0,0,0],
    [0,0,0,0,0,0,0,0,0,0,0,0,0,0,0,0,0,0,0,0,0,0,0,0],
    [0,0,0,0,0,0,0,0,0,0,0,0,0,0,0,0,0,0,0,0,0,0,0,0],
    [0,0,0,0,0,0,0,0,0,0,0,0,0,0,0,0,0,0,0,0,0,0,0,0],
    [0,0,0,0,0,0,0,0,0,0,0,0,0,0,0,0,0,0,0,0,0,0,0,0],
    [0,0,0,0,0,0,0,0,0,0,0,0,0,0,0,0,0,0,0,0,0,0,0,0],
    [0,0,0,0,0,0,0,0,0,0,0,0,0,0,0,0,0,0,0,0,0,0,0,0],
    [0,0,0,0,0,0,0,0,0,0,0,0,0,0,0,0,0,0,0,0,0,0,0,0],
    [0,0,0,0,0,0,0,0,0,0,0,0,0,0,0,0,0,0,0,0,0,0,0,0],
    [0,0,0,0,0,0,0,0,0,0,0,0,0,0,0,0,0,0,0,0,0,0,0,0],
    [0,0,0,0,0,0,0,0,0,0,0,0,0,0,0,0,0,0,0,0,0,0,0,0],
    [0,0,0,0,0,0,0,0,0,0,0,0,0,0,0,0,0,0,0,0,0,0,0,0],
    [0,0,0,0,0,0,0,0,0,0,0,0,0,0,0,0,0,0,0,0,0,0,0,0],
    [0,0,0,0,0,0,0,0,0,0,0,0,0,0,0,0,0,0,0,0,0,0,0,0],
    [0,0,0,0,0,0,0,0,0,0,0,0,0,0,0,0,0,0,0,0,0,0,0,0],
    [0,0,0,0,0,0,0,0,0,0,0,0,0,0,0,0,0,0,0,0,0,0,0,0],
    [0,0,0,0,0,0,0,0,0,0,0,0,0,0,0,0,0,0,0,0,0,0,0,0],
    [0,0,0,0,0,0,0,0,0,0,0,0,0,0,0,0,0,0,0,0,0,0,0,0],
    [0,0,0,0,0,0,0,0,0,0,0,0,0,0,0,0,0,0,0,0,0,0,0,0],
    [0,0,0,0,0,0,0,0,0,0,0,0,0,0,0,0,0,0,0,0,0,0,0,0]
  ]
}