{
	"name": "door_room",
	"tileset": "dungeon",
	"decorationTileset": "dungeon-decoration",
	"overlayTileset": "dungeon-overlay",
	"openings": [
    [-1, 1, "top"],
		[ 2, 1, "top"]
  ],
	"layout": [
		[0,6,32,33,32,32,4,0],
		[0,11,3,32,34,32,4,0],
		[0,0,6,32,32,33,4,0],
		[0,0,6,32,34,32,4,0],
		[0,0,6,33,32,32,4,0],
		[0,0,6,32,32,32,4,0],
		[0,13,9,36,33,32,4,0],
		[0,6,32,32,32,32,4,0]
],
	"decorations": [
		[0,0,0,0,0,0,0,0],
		[0,0,0,0,0,0,0,0],
		[0,0,0,0,0,0,0,0],
		[0,0,0,0,0,0,0,0],
		[0,0,0,0,0,0,0,0],
		[0,0,0,0,0,0,0,0],
		[0,0,0,0,0,0,0,0],
		[0,0,0,0,0,0,0,0]
],
	"overlays": [
		[0,0,0,0,0,0,0,0],
		[0,0,0,0,0,0,0,0],
		[0,0,0,0,0,0,0,0],
		[0,0,0,0,0,0,0,0],
		[0,0,0,0,0,0,0,0],
		[0,0,0,0,0,0,0,0],
		[0,0,0,0,0,0,0,0],
		[0,0,0,0,0,0,0,0]
],
	"npcs": [],
	"items": [],
	"doors": [{
		"type": "red-door-north",
		"id": "door",
		"x": 3,
		"y": 3,
		"open": false
	}],
	"scripts": {}
}