{
  "name": "exitTest_top",
  "tileset": "dungeon-blue",
  "openings": [
    [-1, 1, "top"]
  ],
  "layout": [
    [13,  8,  8,  8,  8,  8,  8,  8,  9, 32, 32, 32, 32, 32, 32,  7,  8,  8,  8,  8,  8,  8,  8, 12],
    [ 6, 15, 20, 15, 15, 21, 15, 15, 16, 32, 32, 32, 32, 32, 32, 14, 15, 15, 21, 15, 15, 21, 15,  4],
    [ 6, 18, 23, 18, 18, 24, 18, 18, 19, 32, 32, 32, 32, 32, 32, 17, 18, 18, 24, 18, 18, 24, 18,  4],
    [ 6, 33, 37, 32, 32, 38, 32, 32, 32, 32, 32, 32, 32, 32, 32, 32, 32, 32, 38, 32, 32, 38, 33,  4],
    [ 6, 33, 33, 32, 32, 32, 32, 32, 32, 32, 32, 32, 32, 32, 32, 32, 32, 36, 32, 32, 32, 36, 33,  4],
    [ 6, 33, 33, 32, 32, 32, 32, 32, 32, 32, 32, 32, 32, 32, 36, 32, 32, 32, 32, 32, 35, 33, 33,  4],
    [ 6, 33, 33, 32, 32, 32, 32, 35, 32, 32, 32, 32, 36, 32, 34, 32, 32, 32, 32, 32, 32, 33, 33,  4],
    [11,  2,  2,  3, 32, 32, 32, 32, 32, 32, 32, 32, 32, 32, 32, 32, 32, 32, 32, 32,  1,  2,  2, 10],

    [ 0,  0,  0,  6, 32, 32, 32, 32, 32, 32, 32, 32, 32, 32, 32, 32, 33, 32, 32, 32,  4,  0,  0,  0],
    [ 0,  0,  0, 11,  2,  2,  3, 32, 32, 32, 32, 32, 32, 32, 32, 32, 33,  1,  2,  2, 10,  0,  0,  0],
    [ 0,  0,  0,  0,  0,  0,  6, 32, 32, 32, 32, 32, 32, 32, 32, 32, 32,  4,  0,  0,  0,  0,  0,  0],
    [ 0,  0,  0,  0,  0,  0,  6, 32, 32, 32, 32, 32, 32, 32, 32, 32, 32,  4,  0,  0,  0,  0,  0,  0],
    [ 0,  0,  0,  0,  0,  0,  6, 32, 32, 32, 32, 32, 32, 32, 32, 32, 32,  4,  0,  0,  0,  0,  0,  0],
    [ 0,  0,  0, 13,  8,  8,  9, 32, 32, 32, 32, 32, 32, 32, 32, 32, 32,  7,  8,  8, 12,  0,  0,  0],
    [ 0,  0,  0,  6, 15, 20, 16, 32, 32, 32, 32, 32, 32, 32, 32, 32, 32, 14, 21, 15,  4,  0,  0,  0],
    [ 0,  0,  0,  6, 18, 23, 19, 32, 32, 32, 32, 32, 32, 32, 32, 32, 32, 17, 24, 18,  4,  0,  0,  0],

    [ 8,  8,  8,  9, 32, 37, 32, 32, 32, 32, 32, 32, 32, 32, 32, 32, 32, 32, 38, 32,  7,  8,  8,  8],
    [15, 15, 20, 16, 32, 32, 32, 32, 32, 32, 32, 32, 32, 32, 32, 32, 32, 32, 32, 32, 14, 21, 15, 15],
    [18, 18, 23, 19, 32, 32, 32, 32, 32, 32, 32, 32, 32, 32, 32, 32, 32, 32, 32, 32, 17, 24, 18, 18],
    [32, 32, 37, 32, 32, 32, 32, 32, 32, 32, 32, 32, 32, 32, 32, 32, 32, 32, 32, 32, 32, 38, 32, 32],
    [32, 33, 33, 32, 32, 32, 32, 32, 32, 32, 32, 32, 32, 32, 32, 32, 32, 36, 32, 32, 32, 36, 33, 32],
    [32, 33, 33, 32, 32, 32, 32, 32, 32, 32, 32, 32, 32, 32, 36, 32, 32, 32, 32, 32, 35, 33, 33, 32],
    [32, 33, 33, 32, 32, 32, 32, 35, 32, 32, 32, 32, 36, 32, 34, 32, 32, 32, 32, 32, 32, 33, 33, 32],
    [11,  2,  2,  3, 32, 32, 32, 32, 32, 32, 32, 32, 32, 32, 32, 32, 32, 32, 32, 32,  1,  2,  2,  2],

    [ 0,  0,  0,  6, 32, 32, 32, 32, 32, 32, 32, 32, 32, 32, 32, 32, 33, 32, 32, 32,  4,  0,  0,  0],
    [ 0,  0,  0, 11,  2,  2,  3, 32, 32, 32, 32, 32, 32, 32, 32, 32, 33,  1,  2,  2, 10,  0,  0,  0],
    [ 0,  0,  0,  0,  0,  0,  6, 32, 32, 32, 32, 32, 32, 32, 32, 32, 32,  4,  0,  0,  0,  0,  0,  0],
    [ 0,  0,  0,  0,  0,  0,  6, 32, 32, 32, 32, 32, 32, 32, 32, 32, 32,  4,  0,  0,  0,  0,  0,  0],
    [ 0,  0,  0,  0,  0,  0,  6, 32, 32, 32, 32, 32, 32, 32, 32, 32, 32,  4,  0,  0,  0,  0,  0,  0],
    [ 0,  0,  0, 13,  8,  8,  9, 32, 32, 32, 32, 32, 32, 32, 32, 32, 32,  7,  8,  8, 12,  0,  0,  0],
    [ 0,  0,  0,  6, 15, 20, 16, 32, 32, 32, 32, 32, 32, 32, 32, 32, 32, 14, 21, 15,  4,  0,  0,  0],
    [ 0,  0,  0,  6, 18, 23, 19, 32, 32, 32, 32, 32, 32, 32, 32, 32, 32, 17, 24, 18,  4,  0,  0,  0],

    [13,  8,  8,  9, 32, 37, 32, 32, 32, 32, 32, 32, 32, 32, 32, 32, 32, 32, 38, 32,  7,  8,  8, 12],
    [ 6, 15, 20, 16, 32, 32, 32, 32, 32, 32, 32, 32, 32, 32, 32, 32, 32, 32, 32, 32, 14, 21, 15,  4],
    [ 6, 18, 23, 19, 32, 32, 32, 32, 32, 32, 32, 32, 32, 32, 32, 32, 32, 32, 32, 32, 17, 24, 18,  4],
    [ 6, 32, 37, 32, 32, 32, 32, 32, 32, 32, 32, 32, 32, 32, 32, 32, 32, 32, 32, 32, 32, 38, 32,  4],
    [ 6, 33, 33, 32, 32, 32, 32, 32, 32, 32, 32, 32, 32, 32, 32, 32, 32, 36, 32, 32, 32, 36, 33,  4],
    [ 6, 33, 33, 32, 32, 32, 32, 32, 32, 32, 32, 32, 32, 32, 36, 32, 32, 32, 32, 32, 35, 33, 33,  4],
    [ 6, 33, 33, 32, 32, 32, 32, 35, 32, 32, 32, 32, 36, 32, 34, 32, 32, 32, 32, 32, 32, 33, 33,  4],
    [11,  2,  2,  2,  2,  2,  2,  2,  3, 32, 32, 32, 32, 32, 32,  1,  2,  2,  2,  2,  2,  2,  2, 10]
  ],
  "npcs": [],
  "scripts": {}
}
