{
  "name": "fourthTest",
  "startRoom": true,
  "tileset": "dungeon",
  "openings": [
    [1, 2, "right"]
  ],
  "layout": [
    [13,  8,  8,  8,  8,  8,  8,  8,  8,  8,  8,  8,  8,  8,  8, 12],
    [ 6, 15, 15, 15, 22, 15, 15, 22, 22, 15, 15, 22, 15, 15, 15,  4],
    [ 6, 18, 18, 18, 25, 18, 18, 25, 25, 18, 18, 25, 18, 18, 18,  4],
    [ 6, 32, 32, 32, 39, 32, 32, 39, 39, 32, 32, 39, 32, 32, 32,  4],
    [ 6, 32, 32, 32, 32, 32, 32, 32, 32, 32, 32, 32, 32, 32, 32,  4],
    [ 6, 32, 32, 32, 32, 32, 32, 32, 32, 32, 32, 32, 32, 32, 32,  4],
    [ 6, 32, 32, 32, 32, 32, 32, 32, 32, 32, 32, 32, 32, 32, 32,  4],
    [ 6, 32, 32, 32, 32, 32, 32, 32, 32, 32, 32, 32, 32, 32, 32,  4],
    [ 6, 32, 32, 32, 32, 32, 32, 32, 32, 32, 32, 32, 32, 32, 32,  7],
    [ 6, 32, 32, 32, 32, 32, 32, 32, 32, 32, 32, 32, 32, 32, 32, 15],
    [ 6, 32, 32, 32, 32, 32, 32, 32, 32, 32, 32, 32, 32, 32, 32, 18],
    [ 6, 32, 32, 32, 32, 32, 32, 32, 32, 32, 32, 32, 32, 32, 32, 32],
    [ 6, 32, 32, 32, 32, 32, 32, 32, 32, 32, 32, 32, 32, 32, 32, 32],
    [ 6, 32, 32, 32, 32, 32, 32, 32, 32, 32, 32, 32, 32, 32, 32, 32],
    [ 6, 32, 32, 32, 32, 32, 32, 32, 32, 32, 32, 32, 32, 32, 32, 32],
    [ 6, 32, 32, 32, 32, 32, 32, 32, 32, 32, 32, 32, 32, 32, 32, 49],
    [ 6, 32, 32, 32, 32, 32, 32, 32, 32, 32, 32, 32, 32, 32, 32,  4],
    [ 6, 32, 32, 32, 32, 32, 32, 32, 32, 32, 32, 32, 32, 32, 32,  4],
    [ 6, 32, 32, 32, 32, 32, 32, 32, 32, 32, 32, 32, 32, 32, 32,  4],
    [ 6, 32, 32, 32, 32, 32, 32, 32, 32, 32, 32, 32, 32, 32, 32,  4],
    [ 6, 32, 32, 32, 32, 32, 32, 32, 32, 32, 32, 32, 32, 32, 32,  4],
    [ 6, 32, 32, 32, 32, 32, 32, 32, 32, 32, 32, 32, 32, 32, 32,  4],
    [ 6, 32, 32, 32, 32, 32, 32, 32, 32, 32, 32, 32, 32, 32, 32,  4],
    [11,  2,  2,  2,  2,  2,  2,  2,  2,  2,  2,  2,  2,  2,  2, 10]
 ],
  "scripts": {}
}

