{
	"name": "intro_road",
	"tileset": "town",
	"decorationTileset": "town-decoration",
	"overlayTileset": "town-overlay",
	"openings": [],
	"layout": [
		[32,143,264,143,264,32,197,198,199,156,194,32,155,32,193,32],
		[32,183,143,183,143,32,197,198,199,34,155,32,36,155,32,156],
		[32,223,183,223,183,34,197,198,199,32,32,73,32,34,155,193],
		[32,264,223,264,223,32,197,198,199,155,155,34,194,32,32,32],
		[157,158,158,158,158,158,236,198,199,32,36,23,24,36,74,32],
		[197,198,198,198,198,198,198,198,199,73,32,63,64,155,32,34],
		[197,198,195,238,238,238,238,238,239,36,156,32,36,32,32,155],
		[197,198,199,32,73,32,36,32,36,193,155,32,194,36,74,32],
		[197,198,199,193,34,74,32,194,32,194,34,36,156,32,32,155],
		[197,198,199,155,32,32,34,32,34,32,32,155,32,34,36,156],
		[197,198,199,156,34,194,32,36,74,32,34,156,32,194,155,32],
		[197,198,199,193,32,155,155,156,155,32,193,32,36,193,32,155]
],
	"decorations": [
		[98,10,51,10,51,0,0,0,0,0,0,0,0,0,98,0],
		[0,50,10,50,10,0,0,0,0,0,0,0,0,0,0,0],
		[0,90,50,90,50,0,0,0,0,101,102,0,0,0,0,0],
		[0,51,90,51,90,0,0,0,0,141,142,0,0,0,0,0],
		[0,0,0,0,0,0,0,0,0,0,0,0,0,0,0,0],
		[0,0,0,0,0,0,0,0,0,0,0,0,98,0,0,0],
		[0,0,0,0,0,0,0,0,0,0,0,0,0,0,0,0],
		[0,0,0,99,100,0,0,0,0,0,0,0,0,0,0,0],
		[0,0,0,139,140,0,0,0,0,0,0,0,0,0,0,0],
		[0,0,0,0,0,0,0,0,0,101,102,0,98,98,0,0],
		[0,0,0,0,0,0,0,0,0,141,142,0,0,0,0,0],
		[0,0,0,0,98,0,0,0,0,0,0,0,0,0,0,0]
],
	"overlays": [
		[0,0,0,0,0,0,0,0,0,0,0,0,0,0,0,0],
		[0,0,0,0,0,0,0,0,0,0,0,0,0,0,0,0],
		[0,0,0,0,0,0,0,0,0,0,0,0,0,0,0,0],
		[0,0,0,0,0,0,0,0,0,0,0,0,0,0,0,0],
		[0,0,0,0,0,0,0,0,0,0,0,0,0,0,0,0],
		[0,0,0,0,0,0,0,0,0,0,0,0,0,0,0,0],
		[0,0,0,0,0,0,0,0,0,0,0,0,0,0,0,0],
		[0,0,0,0,0,0,0,0,0,0,0,0,0,0,0,0],
		[0,0,0,0,0,0,0,0,0,0,0,0,0,0,0,0],
		[0,0,0,0,0,0,0,0,0,0,0,0,0,0,0,0],
		[0,0,0,0,0,0,0,0,0,0,0,0,0,0,0,0],
		[0,0,0,0,0,0,0,0,0,0,0,0,0,0,0,0]
],
	"scripts": {
		"onEntry": [
			{
				"type": "move",
				"target": "player",
				"posX": 7,
				"posY": 3,
				"facingX": 0,
				"facingY": 1
			}, {
				"type": "fadeIn",
				"time": 2000
			},
			{
				"type": "wait",
				"time": 1000
			}, {
				"type": "dialog",
				"portrait": "player_happy",
				"text": [
          "Six years, long time when looking back,",
          "don't you think? But it was definitely worth it,",
          "all the things I've learned. Especially this:"]
			}, {
				"type": "cast",
				"ability": "fireball"
			}, {
				"type": "dialog",
				"portrait": "player_happy",
				"text": [
					"Don't worry my friend, you will get used to it,",
          "at least someday, I hope..."
				]
			}, {
				"type": "fadeOut",
				"time": 2000
			}, {
				"type": "sceneChange",
				"target": "town"
			}
		]
	}
}

