{
	"name": "intro_ceremony",
	"tileset": "dungeon",
	"openings": [],
	"usedNpcTypes": ["red-link"],
	"layout": [
		[13,  8,  8,  8,  8,  8,  8,  8,  8,  8,  8,  8,  8,  8,  8,  8,  8,  8,  8,  8,  8,  8,  8, 12],
		[ 6, 20, 15, 15, 15, 21, 15, 15, 15, 21, 15, 15, 15, 21, 15, 15, 15, 15, 21, 15, 15, 15, 22,  4],
		[ 6, 23, 18, 18, 18, 24, 18, 18, 18, 24, 18, 18, 18, 24, 18, 18, 18, 18, 24, 18, 18, 18, 25,  4],
		[ 9, 37, 33, 32, 32, 38, 32, 32, 32, 38, 32, 32, 32, 38, 32, 32, 32, 32, 38, 32, 32, 33, 39,  4],
		[66, 33, 33, 32, 32, 32, 32, 32, 32, 32, 32, 32, 32, 32, 32, 32, 32, 36, 32, 32, 32, 36, 33,  4],
		[67, 33, 33, 32, 32, 32, 32, 32, 32, 32, 32, 32, 32, 32, 36, 32, 32, 32, 32, 32, 35, 33, 33,  4],
		[68, 33, 33, 32, 34, 32, 32, 35, 32, 32, 32, 32, 32, 32, 32, 32, 32, 32, 32, 32, 32, 33, 33,  4],
		[ 6, 33, 36, 32, 32, 32, 32, 32, 35, 32, 32, 33, 32, 32, 32, 32, 32, 34, 32, 32, 32, 33, 33,  4],
		[11,  2,  2, 46, 40, 40, 40, 40, 40, 40, 51, 32, 32, 50, 40, 40, 40, 40, 40, 40, 47,  2,  2, 10],
		[ 0,  0,  0,  6, 14, 15, 15, 15, 15, 15, 16, 32, 32, 14, 15, 15, 15, 15, 15, 16,  4,  0,  0,  0],
		[ 0,  0,  0,  6, 17, 18, 18, 18, 18, 18, 19, 32, 32, 17, 18, 18, 18, 18, 18, 19,  4,  0,  0,  0],
		[ 0,  0,  0,  6, 32, 32, 32, 32, 32, 32, 32, 32, 32, 32, 32, 32, 32, 32, 36, 32,  4,  0,  0,  0],
		[ 0,  0,  0,  6, 32, 32, 32, 32, 32, 32, 32, 32, 32, 32, 32, 32, 32, 32, 36, 32,  4,  0,  0,  0],
		[ 0,  0,  0,  6, 32, 32, 32, 32, 32, 32, 32, 32, 32, 32, 32, 32, 32, 32, 36, 32,  4,  0,  0,  0],
		[ 0,  0,  0,  6, 32, 32, 32, 53, 32, 32, 43, 32, 32, 43, 32, 32, 53, 32, 32, 32,  4,  0,  0,  0],
		[ 0,  0,  0, 11,  2,  2,  2, 44,  2,  2, 44,  2,  2, 44,  2,  2, 44,  2,  2,  2, 10,  0,  0,  0]
	],
	"scripts": {
		"onEntry": [
			{
				"type": "fadeIn",
				"time": 2000
			},
			{
				"type": "wait",
				"time": 1000
			},
			{
				"type": "walk",
				"target": "player",
				"posX": 3,
				"posY": 4
			},
			{
				"type": "wait",
				"time": 1000
			},
			{
				"type": "move",
				"target": "player",
				"posX": 12,
				"posY": 12,
				"facingX": 0,
				"facingY": -1
			},
			{
				"type": "wait",
				"time": 1000
			},
			{
				"type": "move",
				"target": "player",
				"posX": 21,
				"posY": 4,
				"facingX": -1,
				"facingY": 0
			},
			{
				"type": "wait",
				"time": 1000
			},
			{
				"type": "walk",
				"target": "player",
				"posX": 3,
				"posY": 4
			},
			{
				"type": "wait",
				"time": 1000
			},
			{
				"type": "spawn",
				"npcId": "rl-1",
				"npcType": "red-link",
				"posX": 21,
				"posY": 4
			}
		]
	}
}