{
	"name": "intro_ceremony",
	"tileset": "town",
	"decorationTileset": "town-decoration",
	"overlayTileset": "town-overlay",
	"openings": [],
	"layout": [
		[17,18,18,18,18,18,18,18,18,18,18,18,18,18,18,18,18,18,18,18,18,18,18,59],
		[57,58,58,58,58,58,58,58,58,58,58,58,58,58,58,58,58,58,58,58,58,58,58,59],
		[57,98,98,98,98,98,98,98,98,98,98,98,98,98,98,98,98,98,98,98,98,98,98,59],
		[57,78,78,78,78,78,78,78,78,78,78,78,78,78,78,78,78,78,78,78,78,78,78,59],
		[57,78,78,78,78,78,78,78,78,78,78,78,78,78,78,78,78,78,78,78,78,78,78,59],
		[57,78,78,78,78,78,78,78,78,78,78,78,78,78,78,78,78,78,78,78,78,78,78,59],
		[57,78,78,78,78,78,78,78,78,78,78,78,78,78,78,78,78,78,78,78,78,78,78,59],
		[57,78,78,78,78,78,78,78,78,78,78,78,78,78,78,78,78,78,78,78,78,78,78,59],
		[57,78,78,78,78,78,78,78,78,78,78,78,78,78,78,78,78,78,78,78,78,78,78,59],
		[57,78,78,78,78,78,78,78,78,78,78,78,78,78,78,78,78,78,78,78,78,78,78,59],
		[57,78,78,78,78,78,78,78,78,78,78,78,78,78,78,78,78,78,78,78,78,78,78,59],
		[57,78,78,78,78,78,78,78,78,78,78,78,78,78,78,78,78,78,78,78,78,78,78,59],
		[57,78,78,78,78,78,78,78,78,78,78,78,78,78,78,78,78,78,78,78,78,78,78,59],
		[57,78,78,78,78,78,78,78,78,78,78,78,78,78,78,78,78,78,78,78,78,78,78,59],
		[57,78,78,78,78,78,78,78,78,78,78,78,78,78,78,78,78,78,78,78,78,78,78,59],
		[57,78,78,78,78,78,78,78,78,78,78,78,78,78,78,78,78,78,78,78,78,78,78,59],
		[57,78,78,78,78,78,78,78,78,78,78,78,78,78,78,78,78,78,78,78,78,78,78,59],
		[97,98,98,98,98,98,98,98,98,98,98,98,98,98,98,98,98,98,98,98,98,98,98,99]
	],
	"decorations": [
		[0,0,0,0,0,0,0,0,0,0,0,0,0,0,0,0,0,0,0,0,0,0,0,0],
		[0,0,0,0,0,0,0,0,0,0,0,0,0,0,0,0,0,0,0,0,0,0,0,0],
		[0,0,0,0,0,0,0,0,0,0,0,0,0,0,0,0,0,0,0,0,0,0,0,0],
		[0,0,18,19,19,19,19,20,0,0,18,19,19,19,20,0,0,18,19,19,19,20,0,0],
		[0,0,58,59,59,59,59,60,0,0,58,59,59,59,60,0,0,58,59,59,59,60,0,0],
		[0,0,0,0,0,0,0,0,0,0,0,0,0,0,0,0,0,0,0,0,0,0,0,0],
		[0,0,0,0,0,0,0,0,0,0,0,0,0,0,0,0,0,0,0,0,0,0,0,0],
		[0,0,18,19,19,19,19,20,0,0,18,19,19,19,20,0,0,18,19,19,19,20,0,0],
		[0,0,58,59,59,59,59,60,0,0,58,59,59,59,60,0,0,58,59,59,59,60,0,0],
		[0,0,0,0,0,0,0,0,0,0,0,0,0,0,0,0,0,0,0,0,0,0,0,0],
		[0,0,0,0,0,0,0,0,0,0,0,0,0,0,0,0,0,0,0,0,0,0,0,0],
		[0,0,0,0,0,0,0,0,0,0,0,0,0,0,0,0,0,0,0,0,0,0,0,0],
		[0,0,94,16,16,16,16,16,16,16,16,16,16,16,16,16,16,16,16,16,16,93,0,0],
		[0,0,0,0,0,0,0,0,0,0,0,0,0,0,0,0,0,0,0,0,0,0,0,0],
		[0,0,0,0,0,0,0,0,0,0,0,0,0,0,0,0,0,0,0,0,0,0,0,0],
		[0,101,102,0,0,0,0,0,0,0,39,39,39,0,0,0,0,0,0,0,0,101,102,0],
		[0,141,142,0,0,0,0,0,0,4,5,5,5,6,0,0,0,0,0,0,0,141,142,0],
		[0,0,0,0,0,0,0,0,0,44,45,45,45,46,0,0,0,0,0,0,0,0,0,0]
	],
	"overlays": [
		[0,0,0,0,0,0,0,0,0,0,0,0,0,0,0,0,0,0,0,0,0,0,0,0],
		[0,0,0,0,0,0,0,0,0,0,0,0,0,0,0,0,0,0,0,0,0,0,0,0],
		[0,0,0,0,0,0,0,0,0,0,0,0,0,0,0,0,0,0,0,0,0,0,0,0],
		[0,0,0,0,0,0,0,0,0,0,0,0,0,0,0,0,0,0,0,0,0,0,0,0],
		[0,0,0,0,0,0,0,0,0,0,0,0,0,0,0,0,0,0,0,0,0,0,0,0],
		[0,0,0,0,0,0,0,0,0,0,0,0,0,0,0,0,0,0,0,0,0,0,0,0],
		[0,0,0,0,0,0,0,0,0,0,0,0,0,0,0,0,0,0,0,0,0,0,0,0],
		[0,0,0,0,0,0,0,0,0,0,0,0,0,0,0,0,0,0,0,0,0,0,0,0],
		[0,0,0,0,0,0,0,0,0,0,0,0,0,0,0,0,0,0,0,0,0,0,0,0],
		[0,0,0,0,0,0,0,0,0,0,0,0,0,0,0,0,0,0,0,0,0,0,0,0],
		[0,0,0,0,0,0,0,0,0,0,0,0,0,0,0,0,0,0,0,0,0,0,0,0],
		[0,0,0,0,0,0,0,0,0,0,0,0,0,0,0,0,0,0,0,0,0,0,0,0],
		[0,0,0,0,0,0,0,0,0,0,0,0,0,0,0,0,0,0,0,0,0,0,0,0],
		[0,0,0,0,0,0,0,0,0,0,0,0,0,0,0,0,0,0,0,0,0,0,0,0],
		[0,0,0,0,0,0,0,0,0,0,0,0,0,0,0,0,0,0,0,0,0,0,0,0],
		[0,0,0,0,0,0,0,0,0,0,0,0,0,0,0,0,0,0,0,0,0,0,0,0],
		[0,0,0,0,0,0,0,0,0,0,0,0,0,0,0,0,0,0,0,0,0,0,0,0],
		[0,0,0,0,0,0,0,0,0,0,0,0,0,0,0,0,0,0,0,0,0,0,0,0]
	],
	"npcs": [
		{
			"id": "nk-1",
			"type": "naked-guy",
			"x": 6,
			"y": 4
		}, 		{
			"id": "nk-2",
			"type": "naked-guy",
			"x": 5,
			"y": 4
		}
	],
	"scripts": {
		"onEntry": [
			{
				"type": "move",
				"target": "player",
				"posX": 8,
				"posY": 11,
				"facingX": 1,
				"facingY": 0
			}, {
				"type": "move",
				"target": "nk-2",
				"posX": 12,
				"posY": 11,
				"facingX": -1,
				"facingY": 0
			}, {
				"type": "fadeIn",
				"time": 2000
			},
			{
				"type": "wait",
				"time": 1000
			}, {
				"type": "dialog",
				"target": "npc",
				"portrait": "teacher",
				"text": [
					"Young wizard, congratulations on your graduation",
					"from the Wizard School of Avinau. With this",
					"graduation letter you officially gain the title",
					"WIZARD and are free to explore the wonders",
					"of our world."
				]
			}, {
				"type": "animation",
				"target": "player",
				"animation": "player-walk-e",
				"duration": 2000
			}, {
				"type": "dialog",
				"target": "npc",
				"portrait": "teacher",
				"text": [
					"But to make your graduation official, there is one",
					"last task you need to complete. The graduation",
					"letter misses the signature of our great,",
					"headmaster the arch mage Xidius Razam."
				]
			}, {
				"type": "dialog",
				"target": "player",
				"portrait": "player_notSmiling",
				"text": [
					"..."
				]
			}, {
				"type": "dialog",
				"target": "npc",
				"portrait": "teacher",
				"text": [
					"To get his signature, you have to travel north and",
					"visit him at his residence. He lives near a small",
					"village called Bellwick, where you can certainly",
					"stay during your time there."
				]
			}, {
				"type": "dialog",
				"target": "player",
				"portrait": "player_annoyed",
				"text": [
					"He must be kidding me!",
					"Why haven't they sent an owl?!"
				]
			}, {
				"type": "dialog",
				"target": "npc",
				"portrait": "teacher",
				"text": [
					"But be aware, the great headmaster is a busy man.",
					"He will await your visit four days from now, at",
					"noon. Be at his entrance door at dot, otherwise he",
					"might be occupied otherwise."
				]
			}, {
				"type": "dialog",
				"target": "player",
				"portrait": "player_annoyed",
				"text": [
					"He is serious... Of all the people, it must be",
					"the arch mage.",
					"He is known to be a great wizard, but there are",
					"rumours about his excentrics. And one such rumour",
					"is that he is definitely not a punctual person and",
					"easily distracted. Great Baal, grant me strength!"
				]
			}, {
				"type": "dialog",
				"target": "npc",
				"portrait": "teacher",
				"text": [
					"... 've been an excellent apprentice, may you be",
					"blessed with wisdom."
				]
			}, {
				"type": "fadeOut",
				"time": 2000
			}, {
				"type": "sceneChange",
				"target": "intro_dormRoom2"
			}
		]
	}
}
