{
    "tileset": "test-tileset",
    "layout": [
        [13, 8, 9, 32, 32, 7, 8, 12],
        [6, 14, 16, 32, 32, 14, 16, 4],
        [6, 17, 19, 32, 32, 17, 19, 4],
        [6, 33, 32, 32, 32, 32, 33, 4],
        [6, 33, 32, 32, 32, 32, 33, 4],
        [6, 33, 32, 32, 32, 32, 33, 4],
        [6, 33, 32, 32, 32, 32, 33, 4],
        [11, 2, 3, 32, 32, 1, 2, 10]
    ]
}
