{
    "tileset": "test-tileset",
    "layout": [
        [13,  8,  8,  8,  8,  8,  8,  8,  8,  8,  8,  8,  8, 12],
        [ 6, 14, 14, 14, 14, 14, 14, 14, 14, 14, 14, 16, 16,  4],
        [ 6, 17, 17, 19, 17, 19, 17, 19, 17, 19, 17, 19, 19,  4],
        [ 6, 33, 33, 32, 32, 32, 32, 32, 32, 32, 32, 33, 33,  4],
        [ 6, 33, 33, 32, 32, 32, 32, 32, 32, 32, 32, 33, 33,  4],
        [ 6, 33, 33, 32, 32, 32, 32, 32, 32, 32, 32, 33, 33,  4],
        [ 6, 33, 33, 32, 32, 32, 32, 32, 32, 32, 32, 33, 33,  4],
        [ 6, 33, 33, 32, 32, 32, 32, 32, 32, 32, 32, 33, 33,  4],
        [ 6, 33, 33, 32, 32, 32, 32, 32, 32, 32, 32, 33, 33,  4],
        [ 6, 33, 33, 32, 32, 32, 32, 32, 32, 32, 32, 33, 33,  4],
        [11,  2,  2,  3, 32, 32, 32, 32, 32, 32,  1,  2,  2, 10],
        [-1, -1, -1,  6, 32, 32, 32, 32, 32, 32,  4, -1, -1, -1],
        [-1, -1, -1,  6, 32, 32, 32, 32, 32, 32,  4, -1, -1, -1],
        [-1, -1, -1,  6, 32, 32, 32, 32, 32, 32,  4, -1, -1, -1],
        [-1, -1, -1, 11,  2,  2,  2,  2,  2,  2, 10, -1, -1, -1]
    ]
}
