{
	"tileset": "test-tileset",
	"layout": [
		[13, 8, 9, 32, 32, 7, 8, 12],
		[6, 14, 32, 32, 32, 32, 16, 4],
		[6, 17, 32, 32, 32, 32, 19, 4],
		[6, 33, 32, 32, 32, 32, 33, 4],
		[6, 33, 32, 32, 32, 32, 33, 4],
		[6, 33, 32, 32, 32, 32, 33, 4],
		[6, 33, 32, 32, 32, 32, 33, 4],
		[11, 2, 3, 32, 32, 1, 2, 10]
	]
}