{
  "tileset": "dungeon-blue",
  "openings": [
    [-1, 1, "top"],
    [0, 3, "right"]
  ],
  "layout": [
    [13,  8,  8,  8,  8,  8,  8,  8,  8, 32, 32, 32, 32,  8,  8,  8,  8,  8,  8,  8,  8,  8,  8,  8],
    [ 6, 20, 15, 15, 15, 21, 15, 15, 15, 32, 32, 32, 32, 15, 21, 15, 15, 15, 21, 15, 15, 15, 22, 15],
    [ 6, 23, 18, 18, 18, 24, 18, 18, 18, 32, 32, 32, 32, 18, 24, 18, 18, 18, 24, 18, 18, 18, 24, 18],
    [ 6, 37, 33, 32, 32, 38, 32, 32, 32, 38, 32, 32, 32, 32, 38, 32, 32, 32, 38, 32, 32, 33, 33, 33],
    [ 6, 33, 33, 32, 32, 32, 32, 32, 32, 32, 32, 32, 32, 32, 32, 32, 32, 36, 32, 32, 32, 36, 33, 33],
    [ 6, 33, 33, 32, 32, 32, 32, 32, 32, 32, 32, 32, 32, 32, 36, 32, 32, 32, 32, 32, 35, 33, 33, 33],
    [ 6, 33, 33, 32, 32, 32, 32, 35, 32, 32, 32, 32, 36, 32, 34, 32, 32, 32, 32, 32, 32, 33, 33, 33],
    [11,  2,  2,  3, 32, 32, 32, 32, 32, 32, 32, 32, 32, 32, 32, 32, 32, 32, 32, 32,  1,  2,  2,  2],
    [-1, -1, -1,  6, 32, 36, 32, 32, 32, 32, 32, 32, 32, 32, 32, 32, 33, 32, 32, 32,  4, -1, -1, -1],
    [-1, -1, -1,  6, 32, 36, 32, 32, 32, 32, 32, 32, 32, 32, 32, 32, 33, 32, 32, 32,  4, -1, -1, -1],
    [-1, -1, -1,  6, 32, 32, 32, 32, 32, 32, 32, 32, 32, 32, 32, 32, 32, 32, 36, 32,  4, -1, -1, -1],
    [-1, -1, -1,  6, 32, 32, 32, 32, 32, 32, 32, 32, 32, 32, 32, 32, 32, 32, 36, 32,  4, -1, -1, -1],
    [-1, -1, -1,  6, 32, 32, 32, 32, 32, 32, 32, 32, 32, 32, 32, 32, 32, 32, 36, 32,  4, -1, -1, -1],
    [-1, -1, -1,  6, 32, 32, 32, 32, 32, 32, 32, 32, 32, 32, 32, 32, 32, 32, 36, 32,  4, -1, -1, -1],
    [-1, -1, -1,  6, 32, 32, 32, 32, 32, 32, 32, 32, 32, 32, 32, 32, 32, 32, 32, 32,  4, -1, -1, -1],
    [-1, -1, -1, 11,  2,  2,  2,  2,  2,  2,  2,  2,  2,  2,  2,  2,  2,  2,  2,  2, 10, -1, -1, -1]
  ],
  "npcs": [
    {
      "id": "red-ball",
      "x": 5,
      "y": 4
    },
    {
      "id": "red-ball",
      "x": 5,
      "y": 14
    }
  ],
  "items": [
    {
      "id": "sword",
      "x": 8,
      "y": 8
    },
    {
      "id": "cheese",
      "x": 8,
      "y": 8
    }
  ]
}
