{
  "tileset": "test-tileset",
  "layout": [
      [13,  8,  8,  8,  8,  8,  8,  8,  8,  8,  8,  8,  8,  8,  8,  8,  8,  8,  8,  8,  8,  8,  8,  8, 12],
      [ 6, 20, 15, 15, 15, 21, 15, 15, 15, 21, 15, 26, 27, 28, 15, 21, 15, 15, 15, 21, 15, 15, 15, 22,  4],
      [ 6, 23, 18, 18, 18, 24, 18, 18, 18, 24, 18, 29, 30, 31, 18, 24, 18, 18, 18, 24, 18, 18, 18, 25,  4],
      [ 6, 37, 33, 32, 32, 38, 32, 32, 32, 38, 32, 72, 32, 74, 32, 38, 32, 32, 32, 38, 32, 32, 33, 39,  4],
      [ 6, 33, 33, 32, 32, 32, 32, 32, 32, 32, 32, 32, 32, 32, 32, 32, 32, 32, 36, 32, 32, 32, 36, 33,  4],
      [ 6, 33, 33, 32, 32, 32, 32, 32, 32, 32, 32, 32, 32, 32, 32, 36, 32, 32, 32, 32, 32, 35, 33, 33,  4],
      [ 6, 33, 33, 32, 34, 32, 32, 35, 32, 32, 32, 32, 32, 32, 32, 32, 32, 32, 32, 32, 32, 32, 33, 33,  4],
      [ 6, 33, 33, 32, 32, 32, 32, 32, 32, 32, 32, 36, 32, 32, 32, 32, 32, 32, 32, 32, 32, 32, 33, 33,  4],
      [ 6, 33, 36, 32, 32, 32, 32, 32, 35, 32, 32, 32, 33, 32, 32, 32, 32, 32, 34, 32, 32, 32, 33, 33,  4],
      [ 6, 33, 33, 32, 32, 32, 32, 35, 32, 32, 32, 32, 32, 36, 32, 34, 32, 32, 32, 32, 32, 32, 33, 33,  4],
      [11,  2,  2,  3, 32, 32, 32, 32, 32, 32, 32, 32, 32, 32, 32, 32, 32, 32, 32, 32, 32,  1,  2,  2, 10],
      [-1, -1, -1,  6, 32, 36, 32, 32, 32, 32, 32, 32, 32, 32, 32, 32, 32, 33, 32, 32, 32,  4, -1, -1, -1],
      [-1, -1, -1,  6, 32, 32, 32, 32, 32, 32, 32, 36, 32, 32, 32, 32, 32, 32, 32, 36, 32,  4, -1, -1, -1],
      [-1, -1, -1,  6, 32, 32, 32, 32, 32, 32, 32, 36, 32, 32, 32, 32, 32, 32, 32, 36, 32,  4, -1, -1, -1],
      [-1, -1, -1,  6, 32, 32, 32, 32, 32, 32, 32, 36, 32, 32, 32, 32, 32, 32, 32, 36, 32,  4, -1, -1, -1],
      [-1, -1, -1,  6, 32, 32, 32, 32, 32, 32, 32, 36, 32, 32, 32, 32, 32, 32, 32, 36, 32,  4, -1, -1, -1],
      [-1, -1, -1,  6, 32, 32, 32, 32, 32, 32, 32, 36, 32, 32, 32, 32, 32, 32, 32, 36, 32,  4, -1, -1, -1],
      [-1, -1, -1,  6, 32, 32, 32, 32, 32, 32, 32, 36, 32, 32, 32, 32, 32, 32, 32, 36, 32,  4, -1, -1, -1],
      [-1, -1, -1,  6, 32, 32, 32, 32, 32, 32, 32, 32, 32, 32, 32, 32, 32, 32, 32, 32, 32,  4, -1, -1, -1],
      [-1, -1, -1, 11,  2,  2,  2,  2,  2,  2,  2,  2,  2,  2,  2,  2,  2,  2,  2,  2,  2, 10, -1, -1, -1]
  ],
  "npcs": [
    {
      "id": "red-link",
      "x": 5,
      "y": 4
    }
  ],
  "items": [
    {
      "id": "sword",
      "x": 8,
      "y": 8
    },
    {
      "id": "cheese",
      "x": 8,
      "y": 8
    }
  ]
}
