{
  "name": "startRoom",
  "startRoom": true,
  "tileset": "dungeon",
  "decorationTileset": "dungeon-blue",
  "overlayTileset": "town",
  "openings": [
    [-1, 1, "top"],
    [0, 3, "right"]
  ],
  "layout": [
    [13,  8,  8,  8,  8,  8,  8,  8,  9, 32, 32, 32, 32, 32, 32,  7,  8,  8,  8,  8,  8,  8,  8,  8],
    [ 6, 20, 15, 15, 15, 21, 15, 15, 15, 32, 32, 32, 32, 32, 32, 14, 15, 15, 21, 15, 15, 15, 21, 15],
    [ 6, 23, 18, 18, 18, 24, 18, 18, 18, 32, 32, 32, 32, 32, 32, 17, 18, 18, 24, 18, 18, 18, 24, 18],
    [ 6, 37, 33, 32, 32, 38, 32, 32, 32, 32, 32, 32, 32, 32, 32, 32, 32, 32, 38, 32, 32, 33, 38, 33],
    [ 6, 33, 33, 32, 32, 32, 32, 32, 32, 32, 32, 32, 32, 32, 32, 32, 32, 36, 32, 32, 32, 36, 33, 33],
    [ 6, 33, 33, 32, 32, 32, 32, 32, 32, 32, 32, 32, 32, 32, 36, 32, 32, 32, 32, 32, 35, 33, 33, 33],
    [ 6, 33, 33, 32, 32, 32, 32, 35, 32, 32, 32, 32, 36, 32, 34, 32, 32, 32, 32, 32, 32, 33, 33, 33],
    [11,  2,  2,  3, 32, 32, 32, 32, 32, 32, 32, 32, 32, 32, 32, 32, 32, 32, 32, 32,  1,  2,  2,  2],
    [ 0,  0,  0,  6, 32, 36, 32, 32, 32, 32, 32, 32, 32, 32, 32, 32, 33, 32, 32, 32,  4,  0,  0,  0],
    [ 0,  0,  0,  6, 32, 36, 32, 32, 32, 32, 32, 32, 32, 32, 32, 32, 33, 32, 32, 32,  4,  0,  0,  0],
    [ 0,  0,  0,  6, 32, 32, 32, 32, 32, 32, 32, 32, 32, 32, 32, 32, 32, 32, 36, 32,  4,  0,  0,  0],
    [ 0,  0,  0,  6, 32, 32, 32, 32, 32, 32, 32, 32, 32, 32, 32, 32, 32, 32, 36, 32,  4,  0,  0,  0],
    [ 0,  0,  0,  6, 32, 32, 32, 32, 32, 32, 32, 32, 32, 32, 32, 32, 32, 32, 36, 32,  4,  0,  0,  0],
    [ 0,  0,  0,  6, 32, 32, 32, 32, 32, 32, 32, 32, 32, 32, 32, 32, 32, 32, 36, 32,  4,  0,  0,  0],
    [ 0,  0,  0,  6, 32, 32, 32, 32, 32, 32, 32, 32, 32, 32, 32, 32, 32, 32, 32, 32,  4,  0,  0,  0],
    [ 0,  0,  0, 11,  2,  2,  2,  2,  2,  2,  2,  2,  2,  2,  2,  2,  2,  2,  2,  2, 10,  0,  0,  0]
  ],
  "decorations": [
    [ 0,  0,  0,  0,  0,  0,  0,  0,  0,  0,  0,  0,  0,  0,  0,  0,  0,  0,  0,  0,  0,  0,  0,  0],
    [ 0,  0,  0,  0,  0,  0,  0,  0,  0,  0,  0,  0,  0,  0,  0,  0,  0,  0,  0,  0,  0,  0,  0,  0],
    [ 0,  0,  0,  0,  0,  0,  0,  0,  0,  0,  0,  0,  0,  0,  0,  0,  0,  0,  0,  0,  0,  0,  0,  0],
    [ 0,  0,  0,  0,  0,  0,  0,  0,  0,  0,  0,  0,  0,  0,  0,  0,  0,  0,  0,  0,  0,  0,  0,  0],
    [ 0,  0,  0,  0,  0,  0,  0,  0,  0,  0,  0,  0,  0,  0,  0,  0,  0,  0,  0,  0,  0,  0,  0,  0],
    [ 0,  0,  0,  0,  0,  0,  0,  0,  0,  0,  0,  0,  0,  0,  0,  0,  0,  0,  0,  0,  0,  0,  0,  0],
    [ 0,  0,  0,  0,  0,  0,  0,  0,  0,  0,  0,  0,  0,  0,  0,  0,  0,  0,  0,  0,  0,  0,  0,  0],
    [ 0,  0,  0,  0,  0,  0,  0,  0,  0,  0, 15, 15,  0,  0,  0,  0,  0,  0,  0,  0,  0,  0,  0,  0],
    [ 0,  0,  0,  0,  0,  0,  0,  0,  0,  0, 15, 15,  0,  0,  0,  0,  0,  0,  0,  0,  0,  0,  0,  0],
    [ 0,  0,  0,  0,  0,  0,  0,  0,  0,  0,  0,  0,  0,  0,  0,  0,  0,  0,  0,  0,  0,  0,  0,  0],
    [ 0,  0,  0,  0,  0,  0,  0,  0,  0,  0,  0,  0,  0,  0,  0,  0,  0,  0,  0,  0,  0,  0,  0,  0],
    [ 0,  0,  0,  0,  0,  0,  0,  0,  0,  0,  0,  0,  0,  0,  0,  0,  0,  0,  0,  0,  0,  0,  0,  0],
    [ 0,  0,  0,  0,  0,  0,  0,  0,  0,  0,  0,  0,  0,  0,  0,  0,  0,  0,  0,  0,  0,  0,  0,  0],
    [ 0,  0,  0,  0,  0,  0,  0,  0,  0,  0,  0,  0,  0,  0,  0,  0,  0,  0,  0,  0,  0,  0,  0,  0],
    [ 0,  0,  0,  0,  0,  0,  0,  0,  0,  0,  0,  0,  0,  0,  0,  0,  0,  0,  0,  0,  0,  0,  0,  0],
    [ 0,  0,  0,  0,  0,  0,  0,  0,  0,  0,  0,  0,  0,  0,  0,  0,  0,  0,  0,  0,  0,  0,  0,  0]
  ],
  "overlays": [
    [ 0,  0,  0,  0,  0,  0,  0,  0,  0,  0,  0,  0,  0,  0,  0,  0,  0,  0,  0,  0,  0,  0,  0,  0],
    [ 0,  0,  0,  0,  0,  0,  0,  0,  0,  0,  0,  0,  0,  0,  0,  0,  0,  0,  0,  0,  0,  0,  0,  0],
    [ 0,  0,  0,  0,  0,  0,  0,  0,  0,  0,  0,  0,  0,  0,  0,  0,  0,  0,  0,  0,  0,  0,  0,  0],
    [ 0,  0,  0,  0,  0,  0,  0,  0,  0,  0,  0,  0,  0,  0,  0,  0,  0,  0,  0,  0,  0,  0,  0,  0],
    [ 0,  0,  0,  0,  0,  8,  8,  0,  0,  0,  0,  0,  0,  0,  0,  0,  0,  0,  0,  0,  0,  0,  0,  0],
    [ 0,  0,  0,  0,  0,  8,  8,  0,  0,  0,  0,  0,  0,  0,  0,  0,  0,  0,  0,  0,  0,  0,  0,  0],
    [ 0,  0,  0,  0,  0,  8,  8,  0,  0,  0,  0,  0,  0,  0,  0,  0,  0,  0,  0,  0,  0,  0,  0,  0],
    [ 0,  0,  0,  0,  0,  8,  8,  0,  0,  0,  0,  0,  0,  0,  0,  0,  0,  0,  0,  0,  0,  0,  0,  0],
    [ 0,  0,  0,  0,  0,  0,  0,  0,  0,  0,  0,  0,  0,  0,  0,  0,  0,  0,  0,  0,  0,  0,  0,  0],
    [ 0,  0,  0,  0,  0,  0,  0,  0,  0,  0,  0,  0,  0,  0,  0,  0,  0,  0,  0,  0,  0,  0,  0,  0],
    [ 0,  0,  0,  0,  0,  0,  0,  0,  0,  0,  0,  0,  0,  0,  0,  0,  0,  0,  0,  0,  0,  0,  0,  0],
    [ 0,  0,  0,  0,  0,  0,  0,  0,  0,  0,  0,  0,  0,  0,  0,  0,  0,  0,  0,  0,  0,  0,  0,  0],
    [ 0,  0,  0,  0,  0,  0,  0,  0,  0,  0,  0,  0,  0,  0,  0,  0,  0,  0,  0,  0,  0,  0,  0,  0],
    [ 0,  0,  0,  0,  0,  0,  0,  0,  0,  0,  0,  0,  0,  0,  0,  0,  0,  0,  0,  0,  0,  0,  0,  0],
    [ 0,  0,  0,  0,  0,  0,  0,  0,  0,  0,  0,  0,  0,  0,  0,  0,  0,  0,  0,  0,  0,  0,  0,  0],
    [ 0,  0,  0,  0,  0,  0,  0,  0,  0,  0,  0,  0,  0,  0,  0,  0,  0,  0,  0,  0,  0,  0,  0,  0]
  ],
  "scripts": {}
}
