{
	"openings":[],
	"npcs":[{
		"id": "hilda",
		"questGiverId": "hilda",
		"type": "naked-guy",
		"x": 22,
		"y": 6,
		"script": {
			"repeat": -1,
			"steps": [
				{
					"type": "wait",
					"time": 8000
				},
				{
					"type": "walk",
					"posX": 19,
					"posY": 6
				},
				{
					"type": "animation",
					"animation": "naked-guy-idle-s"
				},
				{
					"type": "wait",
					"time": 4000
				},
				{
					"type": "walk",
					"posX": 22,
					"posY": 6
				},
				{
					"type": "animation",
					"animation": "naked-guy-idle-s"
				},
				{
					"type": "wait",
					"time": 4000
				},
				{
					"type": "walk",
					"posX": 18,
					"posY": 6
				},
				{
					"type": "animation",
					"animation": "naked-guy-idle-s"
				}
			]
		}
	}],
	"items":[],
	"scripts": {},
	"name":"tavern_new",
	"tileset":"til-tavern",
	"decorationTileset":"til-tavern-decoration",
	"overlayTileset":"town-overlay",
	"connections": [{
		"y": 16,
		"x": 11,
		"targetMap": "town_new",
		"targetRoom": "town_new",
		"targetX": 99,
		"targetY": 39
	}],
	"layout": [
		[7,17,18,19,11,12,5,16,5,11,12,9,10,5,11,12,6,3,16,5,5,5,5,8],
		[47,57,58,59,51,52,45,56,45,51,52,49,50,13,51,53,46,43,56,133,45,45,45,48],
		[87,97,98,99,91,92,85,85,85,91,92,89,90,85,91,93,86,83,85,85,85,85,85,88],
		[32,137,138,139,34,73,34,34,34,72,73,34,34,34,72,73,35,32,34,34,34,34,34,35],
		[34,34,34,34,34,34,34,34,34,34,34,34,34,34,34,34,34,34,34,34,34,34,34,34],
		[34,34,34,34,34,34,34,34,34,34,34,34,34,34,34,34,34,34,34,34,34,34,34,34],
		[131,34,34,34,34,34,34,34,34,34,34,34,34,34,34,34,34,34,34,34,34,34,34,34],
		[34,34,34,34,34,34,34,34,34,34,34,34,34,34,34,34,34,34,34,34,34,34,34,34],
		[34,34,34,34,34,34,34,34,34,34,34,34,34,34,34,34,34,34,34,34,34,34,34,34],
		[34,34,34,34,34,34,34,34,34,34,34,34,34,34,34,34,34,34,34,34,34,34,34,132],
		[34,34,34,34,34,34,34,34,34,34,34,34,34,34,34,34,34,34,34,34,34,34,34,34],
		[34,34,34,34,34,34,34,34,34,34,34,34,34,34,34,34,34,34,34,34,34,34,34,34],
		[34,34,34,34,34,34,34,34,34,34,34,34,34,34,34,34,34,34,34,34,34,34,34,34],
		[34,34,34,34,34,34,34,34,34,34,34,34,34,34,34,34,34,34,34,34,34,34,34,34],
		[34,34,34,34,34,34,34,34,34,34,34,34,34,34,34,34,34,34,34,34,34,34,34,34],
		[34,34,34,34,34,34,34,34,34,34,34,34,34,34,34,34,34,34,34,34,34,34,34,34],
		[34,34,34,34,34,34,34,34,34,34,34,34,34,34,34,34,34,34,34,34,34,34,34,34],
		[34,34,34,34,34,34,34,34,34,34,34,34,34,34,34,34,34,34,34,34,34,34,34,34]
	],
	"decorations": [
		[0,0,0,0,0,0,0,0,0,0,0,0,0,0,0,0,0,0,0,0,0,0,0,0],
		[0,0,0,0,0,0,0,0,0,0,0,0,0,0,0,0,0,0,0,0,21,22,23,24],
		[0,0,0,54,0,0,0,0,0,0,0,0,0,0,0,0,0,178,179,180,61,62,63,64],
		[15,0,0,94,47,124,132,133,134,124,128,0,0,124,125,126,82,218,219,220,101,102,103,104],
		[55,0,93,0,0,164,172,5,174,164,0,0,0,164,165,166,17,45,0,0,0,0,0,0],
		[95,0,0,0,0,204,212,213,214,204,0,0,0,204,205,206,57,0,0,0,0,0,0,145],
		[0,0,0,0,0,0,0,0,0,0,0,0,0,0,0,9,270,0,0,0,0,0,0,185],
		[0,0,0,0,0,0,0,96,0,92,0,0,0,0,0,8,310,27,27,28,27,28,0,225],
		[124,125,126,124,0,0,0,124,132,133,134,124,0,0,0,128,349,349,349,349,349,349,0,265],
		[164,165,166,164,0,0,0,164,172,5,174,164,0,0,0,0,0,0,0,0,0,0,0,0],
		[164,165,166,164,0,0,0,204,212,213,214,204,0,0,0,0,0,0,0,0,0,0,0,0],
		[204,205,206,204,0,0,0,0,0,13,86,0,0,0,0,0,0,0,0,0,0,0,0,229],
		[0,0,9,0,0,0,0,0,0,0,0,0,0,0,0,0,0,0,92,0,0,56,0,229],
		[0,0,0,0,0,0,0,0,124,125,126,124,0,0,0,0,124,132,133,134,124,0,0,269],
		[0,124,132,133,134,124,0,0,164,165,166,164,0,0,0,0,164,172,6,174,164,0,0,309],
		[15,164,172,7,174,164,0,0,164,165,166,164,0,0,0,0,204,212,213,214,204,0,0,349],
		[55,204,212,213,214,204,0,0,204,205,206,204,32,0,17,0,0,0,93,0,0,0,1,2],
		[95,0,0,0,0,0,0,0,0,82,0,0,0,0,57,0,0,0,0,0,0,0,41,42]
	],
	"overlays": [
		[0,0,0,0,0,0,0,0,0,0,0,0,0,0,0,0,0,0,0,0,0,0,0,0],
		[0,0,0,0,0,0,0,0,0,0,0,0,0,0,0,0,0,0,0,0,0,0,0,0],
		[0,0,0,0,0,0,0,0,0,0,0,0,0,0,0,0,0,0,0,0,0,0,0,0],
		[0,0,0,0,0,0,0,0,0,0,0,0,0,0,0,0,0,0,0,0,0,0,0,0],
		[0,0,0,0,0,0,0,0,0,0,0,0,0,0,0,0,0,0,0,0,0,0,0,0],
		[0,0,0,0,0,0,0,0,0,0,0,0,0,0,0,0,0,0,0,0,0,0,0,0],
		[0,0,0,0,0,0,0,0,0,0,0,0,0,0,0,0,0,0,0,0,0,0,0,0],
		[0,0,0,0,0,0,0,0,0,0,0,0,0,0,0,0,0,0,0,0,0,0,0,0],
		[0,0,0,0,0,0,0,0,0,0,0,0,0,0,0,0,0,0,0,0,0,0,0,0],
		[0,0,0,0,0,0,0,0,0,0,0,0,0,0,0,0,0,0,0,0,0,0,0,0],
		[0,0,0,0,0,0,0,0,0,0,0,0,0,0,0,0,0,0,0,0,0,0,0,0],
		[0,0,0,0,0,0,0,0,0,0,0,0,0,0,0,0,0,0,0,0,0,0,0,0],
		[0,0,0,0,0,0,0,0,0,0,0,0,0,0,0,0,0,0,0,0,0,0,0,0],
		[0,0,0,0,0,0,0,0,0,0,0,0,0,0,0,0,0,0,0,0,0,0,0,0],
		[0,0,0,0,0,0,0,0,0,0,0,0,0,0,0,0,0,0,0,0,0,0,0,0],
		[0,0,0,0,0,0,0,0,0,0,0,0,0,0,0,0,0,0,0,0,0,0,0,0],
		[0,0,0,0,0,0,0,0,0,0,0,0,0,0,0,0,0,0,0,0,0,0,0,0],
		[0,0,0,0,0,0,0,0,0,0,0,0,0,0,0,0,0,0,0,0,0,0,0,0]
	]}