{
  "name": "thirdTest",
  "tileset": "dungeon-blue",
  "openings": [
    [-1, 1, "top"],
    [ 2, 3, "right"],
    [ 5, 1, "bottom"]
  ],
  "layout": [
    [13,  8,  8,  8,  8,  8,  8,  8,  9, 32, 32, 32, 32, 32, 32,  7,  8,  8,  8,  8,  8,  8,  8, 12],
    [ 6, 15, 20, 15, 15, 21, 15, 15, 16, 32, 32, 32, 32, 32, 32, 14, 15, 15, 21, 15, 15, 21, 15,  4],
    [ 6, 18, 23, 18, 18, 24, 18, 18, 19, 32, 32, 32, 32, 32, 32, 17, 18, 18, 24, 18, 18, 24, 18,  4],
    [ 6, 33, 37, 32, 32, 38, 32, 32, 32, 32, 32, 32, 32, 32, 32, 32, 32, 32, 38, 32, 32, 38, 33,  4],
    [ 6, 33, 33, 32, 32, 32, 32, 32, 32, 32, 32, 32, 32, 32, 32, 32, 32, 36, 32, 32, 32, 36, 33,  4],
    [ 6, 33, 33, 32, 32, 32, 32, 32, 32, 32, 32, 32, 32, 32, 36, 32, 32, 32, 32, 32, 35, 33, 33,  4],
    [ 6, 33, 33, 32, 32, 32, 32, 35, 32, 32, 32, 32, 36, 32, 34, 32, 32, 32, 32, 32, 32, 33, 33,  4],
    [11,  2,  2,  3, 32, 32, 32, 32, 32, 32, 32, 32, 32, 32, 32, 32, 32, 32, 32, 32,  1,  2,  2, 10],

    [-1, -1, -1,  6, 32, 32, 32, 32, 32, 32, 32, 32, 32, 32, 32, 32, 33, 32, 32, 32,  4, -1, -1, -1],
    [-1, -1, -1, 11,  2,  2,  3, 32, 32, 32, 32, 32, 32, 32, 32, 32, 33,  1,  2,  2, 10, -1, -1, -1],
    [-1, -1, -1, -1, -1, -1,  6, 32, 32, 32, 32, 32, 32, 32, 32, 32, 32,  4, -1, -1, -1, -1, -1, -1],
    [-1, -1, -1, -1, -1, -1,  6, 32, 32, 32, 32, 32, 32, 32, 32, 32, 32,  4, -1, -1, -1, -1, -1, -1],
    [-1, -1, -1, -1, -1, -1,  6, 32, 32, 32, 32, 32, 32, 32, 32, 32, 32,  4, -1, -1, -1, -1, -1, -1],
    [-1, -1, -1, 13,  8,  8,  9, 32, 32, 32, 32, 32, 32, 32, 32, 32, 32,  7,  8,  8, 12, -1, -1, -1],
    [-1, -1, -1,  6, 15, 20, 16, 32, 32, 32, 32, 32, 32, 32, 32, 32, 32, 14, 21, 15,  4, -1, -1, -1],
    [-1, -1, -1,  6, 18, 23, 19, 32, 32, 32, 32, 32, 32, 32, 32, 32, 32, 17, 24, 18,  4, -1, -1, -1],

    [13,  8,  8,  9, 32, 37, 32, 32, 32, 32, 32, 32, 32, 32, 32, 32, 32, 32, 38, 32,  7,  8,  8,  8],
    [ 6, 15, 20, 16, 32, 32, 32, 32, 32, 32, 32, 32, 32, 32, 32, 32, 32, 32, 32, 32, 14, 21, 15, 15],
    [ 6, 18, 23, 19, 32, 32, 32, 32, 32, 32, 32, 32, 32, 32, 32, 32, 32, 32, 32, 32, 17, 24, 18, 18],
    [ 6, 32, 37, 32, 32, 32, 32, 32, 32, 32, 32, 32, 32, 32, 32, 32, 32, 32, 32, 32, 32, 38, 32, 32],
    [ 6, 33, 33, 32, 32, 32, 32, 32, 32, 32, 32, 32, 32, 32, 32, 32, 32, 36, 32, 32, 32, 36, 33, 32],
    [ 6, 33, 33, 32, 32, 32, 32, 32, 32, 32, 32, 32, 32, 32, 36, 32, 32, 32, 32, 32, 35, 33, 33, 32],
    [ 6, 33, 33, 32, 32, 32, 32, 35, 32, 32, 32, 32, 36, 32, 34, 32, 32, 32, 32, 32, 32, 33, 33, 32],
    [11,  2,  2,  3, 32, 32, 32, 32, 32, 32, 32, 32, 32, 32, 32, 32, 32, 32, 32, 32,  1,  2,  2,  2],

    [-1, -1, -1,  6, 32, 32, 32, 32, 32, 32, 32, 32, 32, 32, 32, 32, 33, 32, 32, 32,  4, -1, -1, -1],
    [-1, -1, -1, 11,  2,  2,  3, 32, 32, 32, 32, 32, 32, 32, 32, 32, 33,  1,  2,  2, 10, -1, -1, -1],
    [-1, -1, -1, -1, -1, -1,  6, 32, 32, 32, 32, 32, 32, 32, 32, 32, 32,  4, -1, -1, -1, -1, -1, -1],
    [-1, -1, -1, -1, -1, -1,  6, 32, 32, 32, 32, 32, 32, 32, 32, 32, 32,  4, -1, -1, -1, -1, -1, -1],
    [-1, -1, -1, -1, -1, -1,  6, 32, 32, 32, 32, 32, 32, 32, 32, 32, 32,  4, -1, -1, -1, -1, -1, -1],
    [-1, -1, -1, 13,  8,  8,  9, 32, 32, 32, 32, 32, 32, 32, 32, 32, 32,  7,  8,  8, 12, -1, -1, -1],
    [-1, -1, -1,  6, 15, 20, 16, 32, 32, 32, 32, 32, 32, 32, 32, 32, 32, 14, 21, 15,  4, -1, -1, -1],
    [-1, -1, -1,  6, 18, 23, 19, 32, 32, 32, 32, 32, 32, 32, 32, 32, 32, 17, 24, 18,  4, -1, -1, -1],

    [13,  8,  8,  9, 32, 37, 32, 32, 32, 32, 32, 32, 32, 32, 32, 32, 32, 32, 38, 32,  7,  8,  8, 12],
    [ 6, 15, 20, 16, 32, 32, 32, 32, 32, 32, 32, 32, 32, 32, 32, 32, 32, 32, 32, 32, 14, 21, 15,  4],
    [ 6, 18, 23, 19, 32, 32, 32, 32, 32, 32, 32, 32, 32, 32, 32, 32, 32, 32, 32, 32, 17, 24, 18,  4],
    [ 6, 32, 37, 32, 32, 32, 32, 32, 32, 32, 32, 32, 32, 32, 32, 32, 32, 32, 32, 32, 32, 38, 32,  4],
    [ 6, 33, 33, 32, 32, 32, 32, 32, 32, 32, 32, 32, 32, 32, 32, 32, 32, 36, 32, 32, 32, 36, 33,  4],
    [ 6, 33, 33, 32, 32, 32, 32, 32, 32, 32, 32, 32, 32, 32, 36, 32, 32, 32, 32, 32, 35, 33, 33,  4],
    [ 6, 33, 33, 32, 32, 32, 32, 35, 32, 32, 32, 32, 36, 32, 34, 32, 32, 32, 32, 32, 32, 33, 33,  4],
    [11,  2,  2,  2,  2,  2,  2,  2,  3, 32, 32, 32, 32, 32, 32,  1,  2,  2,  2,  2,  2,  2,  2, 10]
  ],
  "npcs": [
    {
      "id": "red-ball",
      "x": 3,
      "y": 5
    },
    {
      "id": "red-ball",
      "x": 22,
      "y": 5
    },
    {
      "id": "red-ball",
      "x": 3,
      "y": 21
    },
    {
      "id": "red-ball",
      "x": 22,
      "y": 21
    },
    {
      "id": "red-ball",
      "x": 3,
      "y": 37
    },
    {
      "id": "red-ball",
      "x": 22,
      "y": 37
    }
  ]
}
