{
	"name": "woodenHouse",
	"tileset": "dungeon-blue",
	"decorationTileset": "dungeon-blue",
	"overlayTileset": "town-overlay",
	"openings": [],
	"layout": [
		[13,8,8,8,8,8,8,8,8,8,8,8,8,8,8,12],
		[6,15,15,15,15,15,15,15,15,15,15,15,15,15,15,4],
		[6,18,18,18,18,18,18,18,18,18,18,18,18,18,18,4],
		[6,32,32,32,32,32,32,32,32,32,32,32,32,32,32,4],
		[6,32,32,32,32,32,32,32,32,32,32,32,32,32,32,4],
		[6,32,32,32,32,32,32,32,32,32,32,32,32,32,32,4],
		[6,32,32,32,32,32,32,32,32,32,26,27,28,32,32,4],
		[42,40,40,40,40,40,40,40,40,40,29,30,31,40,40,41]
],
	"decorations": [
		[0,0,0,0,0,0,0,0,0,0,0,0,0,0,0,0],
		[0,0,0,0,0,0,0,0,0,0,0,0,0,0,0,0],
		[0,0,0,0,0,0,0,0,0,0,0,0,0,0,0,0],
		[0,0,0,0,0,0,0,0,0,0,0,0,0,0,0,0],
		[0,0,0,0,0,0,0,0,0,0,0,0,0,0,0,0],
		[0,0,0,0,0,0,0,0,0,0,0,0,0,0,0,0],
		[0,0,0,0,0,0,0,0,0,0,0,0,0,0,0,0],
		[0,0,0,0,0,0,0,0,0,0,0,0,0,0,0,0]
],
	"overlays": [
		[0,0,0,0,0,0,0,0,0,0,0,0,0,0,0,0],
		[0,0,0,0,0,0,0,0,0,0,0,0,0,0,0,0],
		[0,0,0,0,0,0,0,0,0,0,0,0,0,0,0,0],
		[0,0,0,0,0,0,0,0,0,0,0,0,0,0,0,0],
		[0,0,0,0,0,0,0,0,0,0,0,0,0,0,0,0],
		[0,0,0,0,0,0,0,0,0,0,0,0,0,0,0,0],
		[0,0,0,0,0,0,0,0,0,0,0,0,0,0,0,0],
		[0,0,0,0,0,0,0,0,0,0,0,0,0,0,0,0]
],
	"connections": [{
		"y": 7,
		"x": 12,
		"targetMap": "town"
	}],
	"npcs": [{
		"id": "nk-1",
		"type": "naked-guy",
		"x": 6,
		"y": 6
	}],
	"items": [],
	"scripts": {}
}