{"openings":[[-1,1,"top"]],
    "name": "ZombieRoom",

    "npcs": [
        {
          "id": "zom-1",
          "type": "enemy-zombie",
          "x": 5,
          "y": 11
        },
        {
          "id": "zom-2",
          "type": "enemy-zombie",
          "x": 5,
          "y": 14
        },
        {
            "id": "zom-3",
            "type": "enemy-zombie",
            "x": 9,
            "y": 9
          },
          {
            "id": "zom-4",
            "type": "enemy-zombie",
            "x": 13,
            "y": 9
          }, 
          {
            "id": "zom-5",
            "type": "enemy-zombie",
            "x": 16,
            "y": 11
          },
          {
            "id": "zom-6",
            "type": "enemy-zombie",
            "x": 16,
            "y": 14
          },
           {
            "id": "zom-7",
            "type": "enemy-zombie",
            "x": 16,
            "y": 3
          },
          {
            "id": "zom-8",
            "type": "enemy-zombie",
            "x": 4,
            "y": 8
          },
          {
            "id": "zom-9",
            "type": "enemy-zombie",
            "x": 5,
            "y": 7
          },
          {
            "id": "zom-10",
            "type": "enemy-zombie",
            "x": 16,
            "y": 7
          },
          {
            "id": "zom-11",
            "type": "enemy-zombie",
            "x": 18,
            "y": 8
          },
          {
            "id": "zom-12",
            "type": "enemy-zombie",
            "x": 18,
            "y": 16
          }
      ],
"items":[{"id":"goldKey","x":14,"y":14}],
"scripts":{"onEntry":[]},
"tileset":"dungeon",
    "layout":[
    [13,8,8,8,8,8,8,8,8,8,8,8,8,8,8,8,8,8,8,8,8,8,8,12],
    [6,15,15,15,20,15,15,22,15,15,15,22,15,15,15,22,15,15,15,22,15,15,15,4],
    [6,18,18,18,23,18,18,25,18,18,18,25,18,18,18,25,18,18,18,25,18,18,18,4],
    [6,32,32,32,32,32,32,32,32,32,32,32,32,32,32,32,32,32,32,32,32,32,32,4],
    [6,32,32,36,32,32,32,34,34,34,32,32,32,32,35,32,32,36,32,34,34,32,32,4],
    [6,32,32,32,32,32,32,33,32,34,32,32,32,35,36,36,35,32,32,32,33,33,32,4],
    [6,32,33,32,34,36,32,32,32,32,32,32,32,32,35,32,32,32,32,32,34,33,32,4],
    [6,33,32,32,32,33,33,32,35,32,32,33,32,32,32,32,32,32,32,32,32,33,32,4],
    [6,32,32,32,32,32,32,32,32,32,32,32,32,32,32,32,32,32,32,36,32,33,32,4],
    [6,32,32,32,32,32,32,32,32,32,32,32,32,32,32,32,32,32,32,32,32,33,32,4],
    [6,32,32,32,32,32,32,32,32,32,32,32,32,32,32,32,32,32,32,32,32,32,32,4],
    [6,32,33,33,32,36,32,32,32,33,32,32,32,34,33,32,32,32,32,32,32,32,32,4],
    [6,32,32,33,32,32,33,33,36,32,32,36,33,34,33,33,33,33,32,32,32,32,32,4],
    [6,32,32,33,32,33,32,32,32,33,32,33,33,32,32,32,32,32,32,32,34,32,32,4],
    [6,36,32,33,32,32,32,32,32,33,32,33,32,32,32,32,32,32,32,32,32,36,32,4],
    [6,36,36,33,32,32,32,32,32,32,32,34,32,36,32,32,32,32,32,32,32,34,32,4],
    [6,32,32,32,32,32,32,32,32,32,32,32,32,32,32,32,32,32,32,32,32,32,32,4],
    [6,32,32,32,32,32,32,32,32,32,32,32,32,32,32,32,32,32,32,32,32,32,32,4],
    [6,32,32,32,36,32,32,32,32,32,32,32,32,32,32,32,32,32,36,36,32,32,32,4],
    [6,32,32,33,32,32,32,32,32,32,32,32,32,32,36,36,32,32,32,36,32,33,32,4],
    [6,32,32,33,36,36,32,32,32,32,32,32,32,32,32,32,32,32,33,32,32,33,32,4],
    [6,32,32,32,32,32,32,32,32,53,26,27,28,53,32,32,32,32,32,33,33,32,32,4],
    [6,32,36,32,32,32,32,32,32,52,29,30,31,52,32,32,32,32,32,32,32,32,32,4],
    [11,2,2,2,2,2,2,2,2,2,75,75,75,2,2,2,2,2,2,2,2,2,2,10]],
    
    "decorationTileset":"town-decoration",
    "overlayTileset":"dungeon-overlay",
    "decorations":[
    [0,0,0,0,0,0,0,0,0,0,0,0,0,0,0,32,0,0,0,0,0,0,0,0],
    [0,0,0,0,0,0,0,0,0,0,0,0,0,0,0,0,0,0,0,0,0,0,0,0],
    [0,0,0,0,0,0,0,0,0,0,0,0,0,0,0,0,0,0,0,0,0,0,0,0],
    [0,0,0,0,0,0,0,0,0,0,0,0,0,0,0,0,0,0,0,0,0,0,0,0],
    [0,0,0,0,0,0,0,0,0,0,0,0,0,0,0,0,0,0,0,0,0,0,0,0],
    [0,0,0,0,0,0,0,0,0,0,0,0,0,0,0,0,0,0,0,0,0,0,0,0],
    [0,0,0,0,0,0,0,0,0,0,0,0,0,0,0,0,0,0,0,0,0,0,0,0],
    [0,0,0,0,0,0,0,0,0,0,0,0,0,0,0,32,0,0,0,0,0,0,0,0],
    [0,0,0,32,0,21,22,0,0,0,0,0,0,0,32,32,21,22,0,0,0,0,0,0],
    [0,0,0,32,32,61,62,0,32,32,32,32,0,0,32,32,61,62,0,0,0,0,0,0],
    [0,0,0,0,32,32,32,32,32,0,0,0,0,0,0,0,0,0,32,0,0,0,0,0],
    [0,0,0,0,0,32,32,32,0,32,0,0,0,0,0,0,32,32,32,0,0,0,0,0],
    [0,0,0,0,0,32,32,32,0,0,0,0,0,0,0,0,0,0,0,0,0,0,0,0],
    [0,0,0,0,0,32,32,0,0,0,0,0,0,0,0,0,0,0,0,0,0,0,0,0],
    [0,0,0,0,0,32,32,32,0,0,0,0,0,0,0,0,0,0,0,0,0,0,0,0],
    [0,0,0,0,0,21,22,0,0,0,0,0,0,0,0,0,21,22,0,0,0,0,0,0],
    [0,0,0,0,0,61,62,0,0,0,0,0,0,0,0,0,61,62,0,0,0,0,0,0],
    [0,0,0,0,0,0,0,0,0,0,0,0,0,0,0,0,0,0,0,0,0,0,0,0],
    [0,0,0,0,0,0,0,0,0,0,0,0,0,0,0,0,0,0,0,0,0,0,0,0],
    [0,0,0,0,0,0,0,0,0,0,0,0,0,0,0,0,0,0,0,0,0,0,0,0],
    [0,0,0,0,0,0,0,0,0,0,0,0,0,0,0,0,0,0,0,0,0,0,0,0],
    [0,0,0,0,0,0,0,0,0,0,0,0,0,0,0,0,0,0,0,0,0,0,0,0],
    [0,0,0,0,0,0,0,0,0,0,0,0,0,0,0,0,0,0,0,0,0,0,0,0],
    [0,0,0,0,0,0,0,0,0,0,0,0,0,0,0,0,0,0,0,0,0,0,0,0]],
    
    "overlays":[
    [0,0,0,0,0,0,0,0,0,0,0,0,0,0,0,0,0,0,0,0,0,0,0,0],
    [0,0,0,0,0,0,0,0,0,0,0,0,0,0,0,0,0,0,0,0,0,0,0,0],
    [0,0,0,0,0,0,0,0,0,0,0,0,0,0,0,0,0,0,0,0,0,0,0,0],
    [0,0,0,0,0,0,0,0,0,0,0,0,0,0,0,0,0,0,0,0,0,0,0,0],
    [0,0,0,0,0,0,0,0,0,0,0,0,0,0,0,0,0,0,0,0,0,0,0,0],
    [0,0,0,0,0,0,0,0,0,0,0,0,0,0,0,0,0,0,0,0,0,0,0,0],
    [0,0,0,0,0,0,0,0,0,0,0,0,0,0,0,0,0,0,0,0,0,0,0,0],
    [0,0,0,0,0,0,0,0,0,0,0,0,0,0,0,0,0,0,0,0,0,0,0,0],
    [0,0,0,0,0,0,0,0,0,0,0,0,0,0,0,0,0,0,0,0,0,0,0,0],
    [0,0,0,0,0,0,0,0,0,0,0,0,0,0,0,0,0,0,0,0,0,0,0,0],
    [0,0,0,0,0,0,0,0,0,0,0,0,0,0,0,0,0,0,0,0,0,0,0,0],
    [0,0,0,0,0,0,0,0,0,0,0,0,0,0,0,0,0,0,0,0,0,0,0,0],
    [0,0,0,0,0,0,0,0,0,0,0,0,0,0,0,0,0,0,0,0,0,0,0,0],
    [0,0,0,0,0,0,0,0,0,0,0,0,0,0,0,0,0,0,0,0,0,0,0,0],
    [0,0,0,0,0,0,0,0,0,0,0,0,0,0,0,0,0,0,0,0,0,0,0,0],
    [0,0,0,0,0,0,0,0,0,0,0,0,0,0,0,0,0,0,0,0,0,0,0,0],
    [0,0,0,0,0,0,0,0,0,0,0,0,0,0,0,0,0,0,0,0,0,0,0,0],
    [0,0,0,0,0,0,0,0,0,0,0,0,0,0,0,0,0,0,0,0,0,0,0,0],
    [0,0,0,0,0,0,0,0,0,0,0,0,0,0,0,0,0,0,0,0,0,0,0,0],
    [0,0,0,0,0,0,0,0,0,0,0,0,0,0,0,0,0,0,0,0,0,0,0,0],
    [0,0,0,0,0,0,0,0,0,0,0,0,0,0,0,0,0,0,0,0,0,0,0,0],
    [0,0,0,0,0,0,0,0,0,0,0,0,0,0,0,0,0,0,0,0,0,0,0,0],
    [0,0,0,0,0,0,0,0,0,0,0,0,0,0,0,0,0,0,0,0,0,0,0,0],
    [0,0,0,0,0,0,0,0,0,0,0,0,0,0,0,0,0,0,0,0,0,0,0,0]]}