{
	"name": "intro_dormRoom2",
	"tileset": "town",
  "decorationTileset": "town-decoration",
	"overlayTileset": "town-overlay",
	"openings": [],
	"layout": [
		[13,8,8,8,8,8,8,8,8,8,8,8,8,8,8,8],
		[17,18,18,18,18,18,18,18,18,18,18,18,18,18,18,19],
		[57,58,58,58,58,58,58,58,58,58,58,58,58,58,58,59],
		[57,98,98,98,98,98,98,98,98,98,98,98,98,98,98,59],
		[57,78,78,78,78,78,78,78,78,78,78,78,78,78,78,59],
		[57,78,78,78,78,78,78,78,78,78,78,78,78,78,78,59],
		[57,78,78,78,78,78,78,78,78,78,78,78,78,78,78,59],
		[57,78,78,78,78,78,78,78,78,78,78,78,78,78,78,59],
		[57,78,78,78,78,78,78,78,78,78,78,78,78,78,78,59],
		[57,78,78,78,78,78,78,78,78,78,78,78,78,78,78,59],
		[57,78,78,78,78,78,78,78,78,78,78,78,78,78,78,59],
		[97,98,98,98,98,98,98,98,98,98,98,98,98,98,98,99]
],
	"decorations": [
		[0,0,0,0,0,0,0,0,0,0,0,0,0,0,0,0],
		[0,0,0,0,0,0,0,0,0,0,0,0,0,0,0,0],
		[0,0,0,0,0,0,0,0,0,0,0,0,0,0,0,0],
		[0,0,0,0,0,0,0,0,0,0,0,0,0,0,0,0],
		[0,18,20,0,0,0,0,0,0,0,0,0,0,0,0,0],
		[0,58,60,0,0,0,0,0,0,0,0,0,0,0,0,0],
		[0,0,0,0,0,0,0,0,0,0,0,0,0,0,0,0],
		[0,0,0,0,0,0,0,0,0,0,0,0,0,0,0,0],
		[0,0,0,0,0,0,0,0,0,0,0,0,0,0,0,0],
		[0,0,0,0,0,0,39,0,0,0,0,0,0,0,0,0],
		[0,0,0,0,0,4,5,6,0,0,0,0,0,0,0,0],
		[0,0,0,0,0,44,45,46,0,0,0,0,0,0,0,0]
],
	"overlays": [
		[0,0,0,0,0,0,0,0,0,0,0,0,0,0,0,0],
		[0,0,0,0,0,0,0,0,0,0,0,0,0,0,0,0],
		[0,0,0,0,0,0,0,0,0,0,0,0,0,0,0,0],
		[0,0,0,0,0,0,0,0,0,0,0,0,0,0,0,0],
		[0,0,0,0,0,0,0,0,0,0,0,0,0,0,0,0],
		[0,0,0,0,0,0,0,0,0,0,0,0,0,0,0,0],
		[0,0,0,0,0,0,0,0,0,0,0,0,0,0,0,0],
		[0,0,0,0,0,0,0,0,0,0,0,0,0,0,0,0],
		[0,0,0,0,0,0,0,0,0,0,0,0,0,0,0,0],
		[0,0,0,0,0,0,0,0,0,0,0,0,0,0,0,0],
		[0,0,0,0,0,0,0,0,0,0,0,0,0,0,0,0],
		[0,0,0,0,0,0,0,0,0,0,0,0,0,0,0,0]
],
	"scripts": {
		"onEntry": [
			{
				"type": "move",
				"target": "player",
				"posX": 4,
				"posY": 5,
				"facingX": -1,
				"facingY": 1
			}, {
				"type": "fadeIn",
				"time": 2000
			},
			{
				"type": "wait",
				"time": 1000
			}, {
				"type": "dialog",
				"portrait": "player_sad",
				"text": ["Krumbein, you know, I will miss this school. I will",
                "miss the great times we spent together with", 
                "Samarah and Abraxas, the times you chased him",
                "through the school, Samarah close at your tail,",
                "trying to hit you with minor curses.", 
                "The gargoyle riding and especially sprout class!"]
			}, {
				"type": "dialog",
				"portrait": "player_crying",
				"text": [
					"... awesome astronomy class ... fireball spell ..."
				]
			}, {
				"type": "fadeOut",
				"time": 2000
			}, {
				"type": "sceneChange",
				"target": "intro_road"
			}
		]
	}
}